btn - JButton
chk - JCheckBox
clr - JColorChooser
cmb - JComboBox
ico - JDesktopIcon
edt - JEditorPane
fch - JFileChooser
ifr - JInternalFrame
lbl - JLabel
lyp - JLayeredPane
lst - JList
mnu - JMenuBar
mni - JMenuItem
opt - JOptionPane
pnl - JPanel
pmn - JPopupMenu
prg - JProgressBar
rad - JRadioButton
rot - JRootPane
scb - JScollBar
scr - JScrollPane
spr - JSeparator
sld - JSlider
spn - JSpinner
spl - JSplitPane
tab - JTabbedPaneJTable
tbl - JTable
tbh - JTableHeader
txa - JTextArea
txt - JTextField
txp - JTextPane
tgl - JToggleButton
tlb - JToolBar
tlt - JToolTip
tre - JTree
vpr - JViewport